"lang"
{
"Language"	"greek"
"Tokens"
{
"TrackerUI_ConnectionSpeed"	"Ταχύτητα σύνδεσης διαδικτύου"
"[english]TrackerUI_ConnectionSpeed"	"Internet connection speed"
"TrackerUI_FavoriteWindowLabel"	"Επιλέξτε ποιο παράθυρο Steam να εμφανίζεται όταν το \nπρόγραμμα ξεκινάει, και όταν κάνετε διπλό κλικ στο \nεικονίδιο Ειδοποιήσεων."
"[english]TrackerUI_FavoriteWindowLabel"	"Select which Steam window appears when the \nprogram starts, and when you double-click \nthe Notification Tray icon."
"TrackerUI_FavoriteWindow"	"Αγαπημένο παράθυρο"
"[english]TrackerUI_FavoriteWindow"	"Favorite window"
"Friends_Chat_Title"	"%friend% - Συνομιλία"
"[english]Friends_Chat_Title"	"%friend% - Chat"
"Friends_ChatTo"	"Προς: %friend%"
"[english]Friends_ChatTo"	"To: %friend%"
"Friends_ChatToPlusStatus"	"Προς: %friend% (%status%)"
"[english]Friends_ChatToPlusStatus"	"To: %friend% (%status%)"
"Friends_ChatToPlusInGame"	"Προς: %friend% (παίζει %game%)"
"[english]Friends_ChatToPlusInGame"	"To: %friend% (playing %game%)"
"Friends_UserSays"	"Ο χρήστης %friend% λέει:\n"
"[english]Friends_UserSays"	"%friend% says:\n"
"Friends_TypingMessage"	"Ο χρήστης %friend% πληκτρολογεί ένα μήνυμα."
"[english]Friends_TypingMessage"	"%friend% is typing a message."
"Friends_LastMessageReceived"	"Τελευταίο μήνυμα παραδόθηκε: %date% στις %time%"
"[english]Friends_LastMessageReceived"	"Last message received: %date% at %time%"
"Friends_FriendInfoDialog_Title"	"%friend% - Πληροφορίες Χρήστη"
"[english]Friends_FriendInfoDialog_Title"	"%friend% - User Info"
"Friends_Chat_FriendNameChanged"	"Ο χρήστης %old_name% άλλαξε το όνομα του σε %friend%.\n"
"[english]Friends_Chat_FriendNameChanged"	"%old_name% has changed their name to %friend%.\n"
"Friends_Chat_FriendStateChanged"	"Ο χρήστης %friend% είναι τώρα %status%.\n"
"[english]Friends_Chat_FriendStateChanged"	"%friend% is now %status%.\n"
"Friends_Chat_Send"	"Αποστολή"
"[english]Friends_Chat_Send"	"Send"
"Friends_Chat_CannotSendFriendOffline"	"Ο χρήστης %friend% είναι αυτή τη στιγμή εκτός σύνδεσης, το μήνυμα δεν μπορούσε να αποσταλεί.\n"
"[english]Friends_Chat_CannotSendFriendOffline"	"%friend% is currently offline, message cannot be sent.\n"
"Friends_Chat_InvitedToGame"	"Ο χρήστης %friend% σας προσκάλεσε να παίξετε μαζί στο %game%."
"[english]Friends_Chat_InvitedToGame"	"%friend% has invited you to join them in playing %game%. "
"Friends_Chat_FriendHasChangedGame"	"Ο χρήστης %friend% τώρα παίζει %game%. "
"[english]Friends_Chat_FriendHasChangedGame"	"%friend% is now playing %game%. "
"Friends_Chat_UnknownGame"	"ένα παιχνίδι"
"[english]Friends_Chat_UnknownGame"	"a game"
"Friends_Chat_ClickHereToJoin"	"Κάντε κλικ εδώ για να συνδεθείτε."
"[english]Friends_Chat_ClickHereToJoin"	"Click here to join."
"Friends_Title_Online"	"Φίλοι - %name% (BETA)"
"[english]Friends_Title_Online"	"Friends - %name%  (BETA)"
"Friends_Title_Busy"	"Φίλοι - %name% - Απασχολημένος (BETA)"
"[english]Friends_Title_Busy"	"Friends - %name% - Busy  (BETA)"
"Friends_Title_Away"	"Φίλοι - %name% - Απών (BETA)"
"[english]Friends_Title_Away"	"Friends - %name% - Away  (BETA)"
"Friends_Title_Snooze"	"Φίλοι - %name% - Αδρανής (BETA)"
"[english]Friends_Title_Snooze"	"Friends - %name% - Snooze   (BETA)"
"Friends_Title_Offline"	"Φίλοι - Εκτός σύνδεσης (BETA)"
"[english]Friends_Title_Offline"	"Friends - Offline  (BETA)"
"Friends_online"	"Συνδεδεμένος"
"[english]Friends_online"	"Online"
"Friends_away"	"Απών"
"[english]Friends_away"	"Away"
"Friends_busy"	"Απασχολημένος"
"[english]Friends_busy"	"Busy"
"Friends_snooze"	"Αδρανής"
"[english]Friends_snooze"	"Snooze"
"Friends_offline"	"Εκτός σύνδεσης"
"[english]Friends_offline"	"Offline"
"Friends_MyStatus"	"Η κατάστασή μου"
"[english]Friends_MyStatus"	"My status"
"Friends_AddFriend"	"ΠΡΟΣΘΗΚΗ ΦΙΛΟΥ..."
"[english]Friends_AddFriend"	"Add friend..."
"Friends_Edit_Profile"	"Επεξεργασία προφίλ..."
"[english]Friends_Edit_Profile"	"Edit profile..."
"Friends_FriendList_CurrentGame"	"ΤΡΕΧΟΝ ΠΑΙΧΝΙΔΙ"
"[english]Friends_FriendList_CurrentGame"	"CURRENT GAME"
"Friends_FriendList_InGame"	"ΕΝΤΟΣ ΠΑΙΧΝΙΔΙΟΥ"
"[english]Friends_FriendList_InGame"	"IN GAME"
"Friends_FriendList_Online"	"ΣΥΝΔΕΔΕΜΕΝΟΣ"
"[english]Friends_FriendList_Online"	"ONLINE"
"Friends_FriendList_Offline"	"ΕΚΤΟΣ ΣΥΝΔΕΣΗΣ"
"[english]Friends_FriendList_Offline"	"OFFLINE"
"Friends_SendInstantMessage"	"Αποστολή μηνύματος..."
"[english]Friends_SendInstantMessage"	"Send message..."
"Friends_InviteFriendToGame"	"Πρόσκληση στο παιχνίδι"
"[english]Friends_InviteFriendToGame"	"Invite to game"
"Friends_JoinGame"	"Σύνδεση στο παιχνίδι"
"[english]Friends_JoinGame"	"Join game"
"Friends_ViewGameInfo"	"Εμφάνιση πληροφοριών παιχνιδιού"
"[english]Friends_ViewGameInfo"	"View game info"
"Friends_UserDetails"	"Εμφάνιση πληροφοριών χρήστη"
"[english]Friends_UserDetails"	"View user details"
"Friends_RemoveUser"	"Αφαίρεση αυτού του φίλου..."
"[english]Friends_RemoveUser"	"Remove this friend..."
"Friends_RemoveFriend_Title"	"Φίλοι - Αφαίρεση χρήστη"
"[english]Friends_RemoveFriend_Title"	"Friends - Remove user"
"Friends_RemoveFriend_Info"	"Θέλετε σίγουρα να αφαιρέσετε τον χρήστη %friend% από τη λίστα των φίλων σας;\n\n(Μπορείτε να τον ξαναπροσθέσετε αργότερα από την επιλογή «προσθήκη φίλου» του μενού.)\n"
"[english]Friends_RemoveFriend_Info"	"Are you sure you want to remove %friend% from your friends list?\n\n(You can re-add them later through the 'add friends' menu option.)\n"
"Friends_RemoveFriend_Button"	"Αφαίρεση %friend%"
"[english]Friends_RemoveFriend_Button"	"Remove %friend%"
"Friends_Options"	"Επιλογές"
"[english]Friends_Options"	"Options"
"Friends_Options_Title"	"Επιλογές χρήστη - %name%"
"[english]Friends_Options_Title"	"User options - %name%"
"Friends_Options_ProfileTab"	"Προφίλ"
"[english]Friends_Options_ProfileTab"	"Profile"
"Friends_Options_SoundsTab"	"Ήχοι"
"[english]Friends_Options_SoundsTab"	"Sounds"
"Friends_EnterAccountNameOrEmailAddress"	"Εισάγετε το όνομα λογαριασμού Steam Ή τη διεύθυνση email του ατόμου που επιθυμείτε να προσθέσετε τη λίστα Φίλων σας."
"[english]Friends_EnterAccountNameOrEmailAddress"	"Enter the Steam account name OR email address of the person you wish to add to your Friends list."
"Friends_SearchingForFriend"	"Αναζήτηση για %search%..."
"[english]Friends_SearchingForFriend"	"Searching for %search%..."
"Friends_FriendHasBeenAddedToYourList"	"Ο χρήστης %search% προστέθηκε στη λίστα φίλων σας, με το όνομα '%friend%'."
"[english]Friends_FriendHasBeenAddedToYourList"	"%search% has been added to your friends list, under the name '%friend%'."
"Friends_UnableToFindFriendByThatName"	"Ο χρήστης %search% δε βρέθηκε. Πατήστε «πίσω» αν θέλετε να προσπαθήσετε και να αναζητήσετε ξανά."
"[english]Friends_UnableToFindFriendByThatName"	"Unable to find %search%.  Hit 'back' if you want to try and search again."
"Friends_CannotAddSelfToList"	"Δεν μπορείτε να προσθέσετε τον εαυτό σας στη λίστα φίλων σας."
"[english]Friends_CannotAddSelfToList"	"You can't add yourself to your friends list."
"Friends_CannotAddFriendWhoIsAlreadyInList"	"Ο χρήστης %search% είναι ήδη στη λίστα φίλων σας, με το όνομα '%friend%'."
"[english]Friends_CannotAddFriendWhoIsAlreadyInList"	"%search% is already in your friends list, under the name '%friend%'."
"Friends_ConnectedButOffline"	"Αυτή τη στιγμή εμφανίζεστε Εκτός Σύνδεσης σε όλους τους φίλους σας."
"[english]Friends_ConnectedButOffline"	"You are currently set to appear Offline to all your friends."
"Friends_NoFriendsInList"	"Δεν έχετε ακόμα προσθέσει κανέναν στη λίστα φίλων σας."
"[english]Friends_NoFriendsInList"	"You have not yet added anyone to your Friends list."
"Friends_GoOnline"	"Σύνδεση"
"[english]Friends_GoOnline"	"Sign in"
"Friends_SignIn_RefreshPassword"	"Γίνεται σύνδεση..."
"[english]Friends_SignIn_RefreshPassword"	"Sign in..."
"Friends_SignIn_ActivateFriends"	"Εγγραφή στη Δοκιμαστική Έκδοση των Φίλων..."
"[english]Friends_SignIn_ActivateFriends"	"Join Friends Beta..."
"Friends_ConnectingToFriendsNetwork"	"Γίνεται σύνδεση στο δίκτυο φίλων..."
"[english]Friends_ConnectingToFriendsNetwork"	"Connecting to friends network..."
"Friends_ScanningForFriends"	"Γίνεται λήψη της λίστας φίλων..."
"[english]Friends_ScanningForFriends"	"Downloading friends list..."
"Friends_NotConnectedToFriendsNetwork"	"Δεν ήταν δυνατό να καθιερωθεί σύνδεση με το δίκτυο φίλων. Το Steam θα προσπαθεί αυτόματα να συνδεθεί μέχρι η υπηρεσία γίνει διαθέσιμη."
"[english]Friends_NotConnectedToFriendsNetwork"	"A connection to the friends network could not be established. Steam will automatically retry connection until the service becomes available."
"Friends_NotConnectedToFriendsNetwork_InvalidPassword"	"Πρέπει να συνδεθείτε ξανά στο Steam για να χρησιμοποιήσετε τους Φίλους."
"[english]Friends_NotConnectedToFriendsNetwork_InvalidPassword"	"You need to log back into Steam in order to use Friends."
"Friends_NotConnectedToFriendsNetwork_LoggedInElsewhere"	"Αποσυνδεθήκατε  από τους Φίλους, επειδή αυτός ο λογαριασμός συνδέθηκε από κάπου αλλού."
"[english]Friends_NotConnectedToFriendsNetwork_LoggedInElsewhere"	"You have been signed out of Friends, due to this account being signed in elsewhere."
"Friends_NotConnectedToFriendsNetwork_InvalidVersion"	"Αυτή η έκδοση του Steam είναι πολύ παλιά για να συνδεθεί με τους Φίλους. Επανεκκινήστε το Steam για να παραλάβετε τη νεότερη ενημέρωση."
"[english]Friends_NotConnectedToFriendsNetwork_InvalidVersion"	"This version of Steam is too old to connect to Friends. Restart Steam to receive the latest update."
"Friends_NotConnectedToFriendsNetwork_ServersBusy"	"Οι διακομιστές του Steam είναι αυτή τη στιγμή ανενεργοί για προγραμματισμένη συντήρηση. Οι Φίλοι θα επανασυνδεθούν αυτόματα μόλις γίνουν ξανά διαθέσιμοι."
"[english]Friends_NotConnectedToFriendsNetwork_ServersBusy"	"The Steam servers are currently down for routine maintenance. Friends will automatically reconnect as soon as they come available."
"Friends_NotConnectedToFriendsNetwork_NoConnection"	"Δε μπορούσε να γίνει σύνδεση με τους διακομιστές του Steam. Το Steam θα προσπαθεί αυτόματα να συνδεθεί μέχρι η υπηρεσία γίνει διαθέσιμη."
"[english]Friends_NotConnectedToFriendsNetwork_NoConnection"	"No network connection could be made to the Steam servers. Steam will automatically retry connection until the service becomes available."
"Friends_UserRequestingFriendship_Title"	"Αίτημα φίλου - %friend%"
"[english]Friends_UserRequestingFriendship_Title"	"Friend request - %friend%"
"Friends_UserRequestingFriendship_Info"	"Ο χρήστης %friend% σας πρόσθεσε στη λίστα Φίλων του."
"[english]Friends_UserRequestingFriendship_Info"	"%friend% has added you to their Friends list."
"Friends_AllowUserToSeeMeOnline"	"Επιτρέψτε στον χρήστη %friend% να βλέπει πότε είστε συνδεδεμένος και να έρχεται σε επαφή μαζί σας."
"[english]Friends_AllowUserToSeeMeOnline"	"Allow %friend% to see when you are online and contact you."
"Friends_BlockUserFromSeeingMeOnline"	"Αποκλείστε αυτό το άτομο από το να βλέπει πότε είστε συνδεδεμένοι και να επικοινωνεί μαζί σας."
"[english]Friends_BlockUserFromSeeingMeOnline"	"Block this person from seeing when you are online and contacting you."
"Friends_AddFriend_Title"	"Προσθήκη Φίλου"
"[english]Friends_AddFriend_Title"	"Add Friend"
"Friends_Settings_Title"	"Επιλογές χρήστη - Φίλοι"
"[english]Friends_Settings_Title"	"User options - Friends"
"Friends_FriendInfoDialog_DetailsTab"	"Λεπτομέρειες"
"[english]Friends_FriendInfoDialog_DetailsTab"	"Details"
"Friends_FriendInfoDialog_StatusTab"	"Κατάσταση"
"[english]Friends_FriendInfoDialog_StatusTab"	"Status"
"Friends_FriendlyName"	"Όνομα"
"[english]Friends_FriendlyName"	"Name"
"Friends_RecentlyUsedNames"	"Πρόσφατα χρησιμοποιημένα ονόματα:"
"[english]Friends_RecentlyUsedNames"	"Recently used names:"
"Friends_PlaySoundWhenFriendJoins"	"Αναπαραγωγή ενός ήχου όταν κάποιος φίλος συνδέεται σε ένα παιχνίδι"
"[english]Friends_PlaySoundWhenFriendJoins"	"Play a sound when any friend joins a game"
"Friends_PlaySoundWhenFriendComesOnline"	"Αναπαραγωγή ενός ήχου όταν κάποιος φίλος συνδέεται"
"[english]Friends_PlaySoundWhenFriendComesOnline"	"Play a sound when any friend comes online"
"Friends_PlaySoundWhenReceiveAMessage"	"Αναπαραγωγή ενός ήχου όταν λαμβάνετε ένα μήνυμα"
"[english]Friends_PlaySoundWhenReceiveAMessage"	"Play a sound when you receive a message"
"Friends_NotifyMeWhenUserComesOnline"	"Ειδοποίηση όποτε αυτός ο χρήστης συνδέεται."
"[english]Friends_NotifyMeWhenUserComesOnline"	"Notify me when this user comes online"
"Friends_PlaySoundWhenUserComesOnline"	"Πάντα αναπαραγωγή ενός ήχου όταν αυτός ο χρήστης συνδέεται"
"[english]Friends_PlaySoundWhenUserComesOnline"	"Always play sound when this user comes online"
"Friends_PlaySoundWhenUserJoinsGame"	"Πάντα αναπαραγωγή ενός ήχου όταν αυτός ο χρήστης παίζει ένα παιχνίδι"
"[english]Friends_PlaySoundWhenUserJoinsGame"	"Always play sound when this user plays a game"
"Friends_RemoveUserExplanation"	"Αν αφαιρέσετε αυτόν τον φίλο από τη λίστα σας, δε θα μπορούν να βλέπουν πότε είστε συνδεδεμένος ή να σας στείλουν μηνύματα."
"[english]Friends_RemoveUserExplanation"	"If you remove this friend from your list, they won't be able to see when you are online or send you messages."
"Friends_FriendInvitedToGame_Title"	"ΠΡΟΣΚΛΗΣΗ - %friend%"
"[english]Friends_FriendInvitedToGame_Title"	"INVITE - %friend%"
"Friends_FriendInvitedToGame_Info"	"Μια πρόσκληση για να συνδεθεί στο παιχνίδι σας στάλθηκε στον χρήστη %friend%."
"[english]Friends_FriendInvitedToGame_Info"	"An invitation to join your game has been sent to %friend%."
"Friends_NotifyFriendOnline_Title"	"%friend% - Ειδοποιήσεις φίλων"
"[english]Friends_NotifyFriendOnline_Title"	"%friend% - Friends online notification"
"Friends_NotifyFriendOnline_Info"	"Ο φίλος σας %friend% συνδέθηκε."
"[english]Friends_NotifyFriendOnline_Info"	"Your friend %friend% has come online."
"Friends_RefreshLogin_Title"	"Steam - Ανανέωση σύνδεσης"
"[english]Friends_RefreshLogin_Title"	"Steam - Refresh login"
"Friends_RefreshLogin"	"Παρακαλούμε επανεισάγετε τις πληροφορίες σύνδεσης του Steam σας για να συνδεθείτε με τους φίλους σας."
"[english]Friends_RefreshLogin"	"Please re-enter your Steam login details in order to sign into Friends."
"Friends_AccountName"	"Λογαριασμός"
"[english]Friends_AccountName"	"Account name"
"Friends_Login_Btn"	"Σύνδεση"
"[english]Friends_Login_Btn"	"Login"
"Friends_Login_Password"	"Κωδικός"
"[english]Friends_Login_Password"	"Password"
"Friends_CurrentlyInBeta"	"Αυτή τη στιγμή δεν είστε γραμμένος στη Δοκιμαστική Έκδοση των Φίλων."
"[english]Friends_CurrentlyInBeta"	"You are currently not part of the Friends Beta."
"Friends_JoinFriendsBeta_Title"	"Φίλοι - Σύνδεση στη Δοκιμαστική Έκδοση"
"[english]Friends_JoinFriendsBeta_Title"	"Friends - Join Beta"
"Friends_ActivateFriendsBeta"	"Σύνδεση στη Δοκιμαστική Έκδοση των Φίλων"
"[english]Friends_ActivateFriendsBeta"	"Join Friends Beta"
"Friends_JoinFriendsBeta_Info"	"Η νέα έκδοση των Φίλων είναι αυτή τη στιγμή σε δοκιμαστική έκδοση.\nΠαρακαλώ ρίξτε της μια ματιά προσθέτοντας μερικούς φίλους στη λίστα σας.\n\nΓια να αναφέρετε ένα πρόβλημα ή για να διαβάσετε μια λίστα με γνωστά ζητήματα, παρακαλούμε επισκεφτείτε:"
"[english]Friends_JoinFriendsBeta_Info"	"The new version of Friends is currently in beta.\nPlease give it a try by adding a few friends to your list.\n\nTo report a problem or to read a list of known issues, please visit:"
"Friends_NameToUseInFriendsBeta"	"Για να συνεχίσετε, εισάγετε ένα όνομα για τον εαυτό σας:"
"[english]Friends_NameToUseInFriendsBeta"	"To continue, enter a Friends name for yourself:"
"Friends_BetaHomePage"	"Η σελίδα πληροφοριών για τη δοκιμαστική έκδοση των Φίλων"
"[english]Friends_BetaHomePage"	"The Friends Beta information page"
}
}
