"lang"
{
"Language"	"czech"
"Tokens"
{
"SteamAddOn_GameTitle"	"%s1 – Steam hra"
"[english]SteamAddOn_GameTitle"	"%s1 - Steam Game"
"SteamAddOn_AppTitle"	"%s1 – Steam Aplikace"
"[english]SteamAddOn_AppTitle"	"%s1 - Steam App"
"SteamAddOn_Yes"	"Ano"
"[english]SteamAddOn_Yes"	"Yes"
"SteamAddOn_No"	"Ne"
"[english]SteamAddOn_No"	"No"
"SteamAddOn_Black"	"Černá"
"[english]SteamAddOn_Black"	"Black"
"SteamAddOn_White"	"Bílá"
"[english]SteamAddOn_White"	"White"
"SteamAddOn_Red"	"Červená"
"[english]SteamAddOn_Red"	"Red"
"SteamAddOn_Turn"	"Kolo"
"[english]SteamAddOn_Turn"	"Turn"
"SteamAddOn_TurnLabel"	"Kolo: %s1"
"[english]SteamAddOn_TurnLabel"	"Turn: %s1"
"SteamAddOn_WaitOpponentColor_Title"	"%s1 – Čeká se na soupeřův výběr barvy"
"[english]SteamAddOn_WaitOpponentColor_Title"	"%s1 - Waiting for Opponent Color Choice"
"SteamAddOn_WaitOpponentColor_Text"	"Vytváření hry %s1. Čeka se na %s2, aby si vybral barvu..."
"[english]SteamAddOn_WaitOpponentColor_Text"	"Setting up %s1 game. Waiting for %s2 to pick color..."
"SteamAddOn_PickColor_Title"	"%s1 – Vyberte si svou barvu"
"[english]SteamAddOn_PickColor_Title"	"%s1 - Decide Your Color"
"SteamAddOn_PickColor_Text"	"Vytváření hry %s1. Jakou barvu byste chtěli?"
"[english]SteamAddOn_PickColor_Text"	"Setting Up %s1 game. What color would you like to be?"
"SteamAddOn_ColorWhite"	"Jste bílý."
"[english]SteamAddOn_ColorWhite"	"You are White. "
"SteamAddOn_ColorBlack"	"Jste černý."
"[english]SteamAddOn_ColorBlack"	"You are Black. "
"SteamAddOn_ColorRed"	"Jste červený."
"[english]SteamAddOn_ColorRed"	"You are Red. "
"SteamAddOn_YourMove"	"Jste na řadě.\n"
"[english]SteamAddOn_YourMove"	"It is your Move.\n"
"SteamAddOn_OppMove"	"Soupeř je na řadě. \n"
"[english]SteamAddOn_OppMove"	"It is your opponent's move. \n"
"SteamAddOn_PlayerRejoin"	"%s1 se znovu připojil ke hře.\n"
"[english]SteamAddOn_PlayerRejoin"	"%s1 has rejoined game.\n"
"SteamAddOn_RejoinDenied_Title"	"%s1 - Znovupřipojení odmítnuto"
"[english]SteamAddOn_RejoinDenied_Title"	"%s1 - Re-join Denied"
"SteamAddOn_RejoinDenied_Text"	"Váš soupeř se odmítl znovu připojit do hry."
"[english]SteamAddOn_RejoinDenied_Text"	"Your opponent has declined to rejoin the game."
"SteamAddOn_Turn_GameOver"	"Tah: %s1 %s2 vyhrál.\n"
"[english]SteamAddOn_Turn_GameOver"	"Turn: %s1 %s2 has won.\n"
"SteamAddOn_GameOver_Win"	"Porazil jste %s1 ve hře %s2."
"[english]SteamAddOn_GameOver_Win"	"You have beaten %s1 in %s2."
"SteamAddOn_GameOver_Loss"	"%s1 vás porazil ve hře %s2."
"[english]SteamAddOn_GameOver_Loss"	"%s1 has beaten you in %s2."
"SteamAddOn_GameOver_Tie"	"%s1 hra skončila nerozhodně."
"[english]SteamAddOn_GameOver_Tie"	"%s1 game has ended in a tie."
"SteamAddOn_Resign_Title"	"%s1 – Soupeř odstoupil ze hry"
"[english]SteamAddOn_Resign_Title"	"%s1 - Opponent Resigned From Game"
"SteamAddOn_Resign_Text"	"Váš soupeř odstoupil ze hry."
"[english]SteamAddOn_Resign_Text"	"Your opponent has resigned from the game."
"SteamAddOn_GameOver_Title"	"%s1 – Konec hry"
"[english]SteamAddOn_GameOver_Title"	"%s1 - Game Over"
"SteamAddOn_WaitingForMoveHistory"	"Čeká se na historii tahů...\n"
"[english]SteamAddOn_WaitingForMoveHistory"	"Waiting for move history...\n"
"SteamAddOn_QuitGameConfirm_Title"	"Ukončit hru"
"[english]SteamAddOn_QuitGameConfirm_Title"	"Quit Game"
"SteamAddOn_QuitGameConfirm_Text"	"Opravdu chcete opustit tuto hru?"
"[english]SteamAddOn_QuitGameConfirm_Text"	"Are you sure you want to quit this game?"
"SteamAddOn_ConfirmResign_Title"	"Potvrďte odstoupení"
"[english]SteamAddOn_ConfirmResign_Title"	"Confirm Resign"
"SteamAddOn_ConfirmResign_Text"	"Opravdu chcete odstoupit?"
"[english]SteamAddOn_ConfirmResign_Text"	"Are you sure you want to resign?"
"SteamAddOn_ResignFromGame_Title"	"Odstoupit ze hry"
"[english]SteamAddOn_ResignFromGame_Title"	"Resign From Game"
"SteamAddOn_ResignFromGame_Text"	"Odstoupil jste ze hry."
"[english]SteamAddOn_ResignFromGame_Text"	"You have resigned from the game."
"SteamAddOn_Btn_CloseGameWindow"	"Zavřít herní okno"
"[english]SteamAddOn_Btn_CloseGameWindow"	"Close Game Window"
"SteamAddOn_Btn_KeepGameWindow"	"Zachovat herní okno"
"[english]SteamAddOn_Btn_KeepGameWindow"	"Keep Game Window"
"SteamAddOn_Btn_Pass"	"&Předat"
"[english]SteamAddOn_Btn_Pass"	"&Pass"
"SteamAddOn_Btn_Resign"	"&Odstoupit"
"[english]SteamAddOn_Btn_Resign"	"&Resign"
"SteamAddOn_Btn_ShowHistory"	"Zobrazit &Historii"
"[english]SteamAddOn_Btn_ShowHistory"	"Show &History"
"SteamAddOn_Btn_Send"	"&Odeslat"
"[english]SteamAddOn_Btn_Send"	"&Send"
"SteamAddOn_Opp_Offline"	"%s1 se odpojil.\n"
"[english]SteamAddOn_Opp_Offline"	"%s1 has gone offline.\n"
"SteamAddOn_Opp_Online"	"%s1 se opět připojil."
"[english]SteamAddOn_Opp_Online"	"%s1 has come back online."
"SteamAddOn_Opp_ExitGame"	"%s1 opustil hru.\n"
"[english]SteamAddOn_Opp_ExitGame"	"%s1 has exited the game.\n"
"SteamAddOn_Waiting_Rejoin"	"Čeká se na znovupřipojení hráče.\n"
"[english]SteamAddOn_Waiting_Rejoin"	" Waiting for player to re-join game.\n"
"SteamAddOn_Close"	"Zavřít"
"[english]SteamAddOn_Close"	"Close"
"SteamAddOn_ReviewMoves"	"Pro zhlédnutí změn v tabulce,\nna ně níže klikněte."
"[english]SteamAddOn_ReviewMoves"	"To review moves on the board,\nclick on them below."
"SteamAddOn_BuddyInvite"	"Pozvat uživatele %s1"
"[english]SteamAddOn_BuddyInvite"	"Invite %s1"
"SteamAddOn_InvitationTitle"	"%s1 – Pozvánka"
"[english]SteamAddOn_InvitationTitle"	"%s1 - Invitation"
"SteamAddOn_InvitationText"	"%s1 Vás pozval do hry %s2."
"[english]SteamAddOn_InvitationText"	"%s1 has invited you to %s2."
"SteamAddOn_InviteWaitTitle"	"%s1 – Čeká se na odpověď na pozvánku"
"[english]SteamAddOn_InviteWaitTitle"	"%s1 - Waiting on Invite Response"
"SteamAddOn_InviteWaitText"	"Čeká se na %s1 odpověď na pozvánku od %s2"
"[english]SteamAddOn_InviteWaitText"	"Waiting on %s1 Invite Response from %s2"
"SteamAddOn_InviteRejectedTitle"	"%s1 – Pozvánka odmítnuta"
"[english]SteamAddOn_InviteRejectedTitle"	"%s1 - Invite Rejected"
"SteamAddOn_InviteRejectedText"	"%s1 odmítl Vaší pozvánku."
"[english]SteamAddOn_InviteRejectedText"	"%s1 has rejected your invitation."
"SteamAddOn_OtherPlayerAbortTitle"	"Předčasný Konec"
"[english]SteamAddOn_OtherPlayerAbortTitle"	"Early Quit"
"SteamAddOn_OtherPlayerAbortText"	"%s1 předčasně opustil hru."
"[english]SteamAddOn_OtherPlayerAbortText"	"%s1 has quit the game early."
"SteamAddOn_RejoinTitle"	"%s1 – Znovupřipojit"
"[english]SteamAddOn_RejoinTitle"	"%s1 - Re-join"
"SteamAddOn_RejoinText"	"Přihlásili jste se do sítě přátel.\nZnovu spojit %s1 s %s2?"
"[english]SteamAddOn_RejoinText"	"You have signed on to the Friends Network.\nRe-join %s1 with %s2?"
"SteamAddOn_Btn_Accept"	"&Přijmout"
"[english]SteamAddOn_Btn_Accept"	"&Accept"
"SteamAddOn_Btn_Reject"	"&Odmítnout"
"[english]SteamAddOn_Btn_Reject"	"&Reject"
"SteamAddOn_Btn_Yes"	"&Ano"
"[english]SteamAddOn_Btn_Yes"	"&Yes"
"SteamAddOn_Btn_No"	"&Ne"
"[english]SteamAddOn_Btn_No"	"&No"
"SteamAddOn_WaitingAbortTitle"	"%s1 – Skončil předčasně"
"[english]SteamAddOn_WaitingAbortTitle"	"%s1 - Ended Early"
"SteamAddOn_WaitingAbortText"	"Během čekání na data %s1 skončil."
"[english]SteamAddOn_WaitingAbortText"	"While waiting for data, %s1 has ended."
"SteamAddOn_LastMoveMade"	"Poslední přijatý tah: %s1 na %s2"
"[english]SteamAddOn_LastMoveMade"	"Last move received: %s1 at %s2"
"SteamAddOn_InvitingWaitingResponse"	"Pozvali jste hráče %s1, čeká se na odpověď...\n"
"[english]SteamAddOn_InvitingWaitingResponse"	"You have invited %s1, waiting on response...\n"
"SteamAddOn_AskingHostPermission"	"Žádáte hostitele o svolení pozvat hráče %s1.\n"
"[english]SteamAddOn_AskingHostPermission"	"You are asking the host for permission to invite %s1.\n"
"SteamAddOn_InvitingToGame"	"Pozvání hráče %s1 do hry.\n"
"[english]SteamAddOn_InvitingToGame"	"Inviting %s1 to game.\n"
"SteamAddOn_PlayerJoined"	"%s1 se připojil.\n"
"[english]SteamAddOn_PlayerJoined"	"%s1 has joined.\n"
"SteamAddOn_PlayerDeclinedInvite"	"%s1 odmítl pozvánku.\n"
"[english]SteamAddOn_PlayerDeclinedInvite"	"%s1 has declined the invitation.\n"
"SteamAddOn_PlayerInvitePlayerWaitingResponse"	"%s1 pozval hráče %s2, čeká se na odpověď...\n"
"[english]SteamAddOn_PlayerInvitePlayerWaitingResponse"	"%s1 has invited %s2, waiting on response...\n"
"SteamAddOn_InviteQuitTitle"	"%s1 – Hra skončila"
"[english]SteamAddOn_InviteQuitTitle"	"%s1 - Game Ended"
"SteamAddOn_InviteQuitText"	"Hra skončila během čekání na odpověď."
"[english]SteamAddOn_InviteQuitText"	"The game has ended while waiting for your response."
"SteamAddOn_HostCancelInviteTitle"	"%s1 – Pozvánka zrušena"
"[english]SteamAddOn_HostCancelInviteTitle"	"%s1 - Invite Cancelled"
"SteamAddOn_HostCancelInviteText"	"Hostitel zrušil vaší pozvánku."
"[english]SteamAddOn_HostCancelInviteText"	"The host has cancelled your invitation."
"SteamAddOn_WaitingStartInfo_Title"	"%s1 – Čeká se na informace o hře"
"[english]SteamAddOn_WaitingStartInfo_Title"	"%s1 - Waiting for Game Information"
"SteamAddOn_WaitingStartInfo_Text"	"Čeká se na informace o hře od hostitele..."
"[english]SteamAddOn_WaitingStartInfo_Text"	"Waiting for starting game information from host..."
"SteamAddOn_UserInvited"	"%s1 pozván..."
"[english]SteamAddOn_UserInvited"	"%s1 Invited..."
"SteamAddOn_HostQuitTitle"	"%s1 – Hostitel skončil"
"[english]SteamAddOn_HostQuitTitle"	"%s1 - Host Quit"
"SteamAddOn_HostQuitText"	"Hostitel ukončil hru %s1."
"[english]SteamAddOn_HostQuitText"	"Host has quit %s1."
"SteamAddOn_GameOver_TeamWin"	"Váš tým porazil druhý tým ve hře %s1."
"[english]SteamAddOn_GameOver_TeamWin"	"Your team has beaten the other team in %s1."
"SteamAddOn_GameOver_TeamLoss"	"Druhý tým porazil váš tým ve hře %s1."
"[english]SteamAddOn_GameOver_TeamLoss"	"The other team has beaten your team in %s1."
"SteamAddOn_Invite"	"Pozvat"
"[english]SteamAddOn_Invite"	"Invite"
"SteamAddOn_Cancel"	"Zrušit"
"[english]SteamAddOn_Cancel"	"Cancel"
"SteamAddOn_Points"	"Body:"
"[english]SteamAddOn_Points"	"Points:"
"SteamAddOn_Score"	"Skóre:"
"[english]SteamAddOn_Score"	"Score:"
"SteamAddOn_North"	"Sever:"
"[english]SteamAddOn_North"	"North:"
"SteamAddOn_South"	"Jih:"
"[english]SteamAddOn_South"	"South:"
"SteamAddOn_West"	"Západ:"
"[english]SteamAddOn_West"	"West:"
"SteamAddOn_East"	"Východ:"
"[english]SteamAddOn_East"	"East:"
"SteamAddOn_LastTrick"	"Poslední trik"
"[english]SteamAddOn_LastTrick"	"Last Trick"
"SteamAddOn_CurrentTrick"	"Současný trik"
"[english]SteamAddOn_CurrentTrick"	"Current Trick"
"SteamAddOn_ShowScore"	"Zobrazit skóre"
"[english]SteamAddOn_ShowScore"	"Show Score"
"SteamAddOn_HideScore"	"Skrýt skóre"
"[english]SteamAddOn_HideScore"	"Hide Score"
"SteamAddOn_StartGame"	"Zahájit hru"
"[english]SteamAddOn_StartGame"	"Start Game"
"SteamAddOn_UserLeftGameTitle"	"%s1 – Uživatel opustil hru"
"[english]SteamAddOn_UserLeftGameTitle"	"%s1 - User Left Game"
"SteamAddOn_UserLeftGameText"	"%s1 opustil hru.\n"
"[english]SteamAddOn_UserLeftGameText"	"%s1 has left the game.\n"
"SteamAddOn_MatchName"	"Jméno zápasu: %s1"
"[english]SteamAddOn_MatchName"	"Match Name: %s1"
"SteamAddOn_WaitingForDeal"	"Čeká se, až hostitel rozdá další partii.\n"
"[english]SteamAddOn_WaitingForDeal"	"We are waiting for host to deal out the hand.\n"
"SteamAddOn_DealNextHand"	"Rozdat další partii"
"[english]SteamAddOn_DealNextHand"	"Deal Next Hand"
"SteamAddOn_RoundCompleted"	"Kolo dokončeno."
"[english]SteamAddOn_RoundCompleted"	"Round Completed."
"SteamAddOn_DetailsAddendum"	"%s1\nPodrobnosti: %s2"
"[english]SteamAddOn_DetailsAddendum"	"%s1\nDetails: %s2"
"SteamAddOn_SteamLoading"	"%s1 – Nahrává se"
"[english]SteamAddOn_SteamLoading"	"%s1 - Loading"
"SteamAddOn_UpdatingAddOnsFiles"	"Aktualizuje se %s1 souborů..."
"[english]SteamAddOn_UpdatingAddOnsFiles"	"Updating %s1 files..."
"SteamAddOn_OtherPlayerUpdating"	"Další hráč potřebuje aktualizovat hru..."
"[english]SteamAddOn_OtherPlayerUpdating"	"Other player needs to update game..."
"SteamAddOn_PlayerLoggedOff"	"%s1 se odhlásil.\n"
"[english]SteamAddOn_PlayerLoggedOff"	"%s1 has logged off.\n"
"SteamAddOn_HostCancelledDuringAccept"	"Hostitel zrušil naši pozvánku, jakmile jsme ji přijímali.\n"
"[english]SteamAddOn_HostCancelledDuringAccept"	"Host cancelled our invitation as we were accepting.\n"
"SteamAddOn_CancellingInvitation"	"Ruší se pozvánka pro %s1.\n"
"[english]SteamAddOn_CancellingInvitation"	"Cancelling invitation to %s1.\n"
"SteamAddOn_HostCancelOtherPlayer"	"Hostitel (%s1) zrušil pozvánku pro %s2.\n"
"[english]SteamAddOn_HostCancelOtherPlayer"	"Host (%s1) cancel invitation to %s2.\n"
"SteamAddOn_PlayerAcceptedInvite"	"%s1 přijal pozvánku a nyní zjišťuje aktualizace...\n"
"[english]SteamAddOn_PlayerAcceptedInvite"	"%s1 has accepted the invitation and is now checking for updates...\n"
"SteamAddOn_WaitingQuit"	"%s1 – Konec"
"[english]SteamAddOn_WaitingQuit"	"%s1 - Quit"
"SteamAddOn_HostInviteOffline"	"%s1 se odpojil, ruší se žádost o pozvánku do hry %s2"
"[english]SteamAddOn_HostInviteOffline"	"%s1 has gone offline, ending invite request to %s2"
"SteamAddOn_HostRejoinOffline"	"%s1 se odpojil, ruší se žádost o znovupřipojení do hry %s2"
"[english]SteamAddOn_HostRejoinOffline"	"%s1 has gone offline, ending rejoin request to %s2"
"SteamAddOn_HostInviteQuit"	"%s1 opustil hru, ruší se pozvánka do hry %s2"
"[english]SteamAddOn_HostInviteQuit"	"%s1 has quit, ending invite to %s2"
"SteamAddOn_CheckingForUpdates"	"Ověřování aktualizací..."
"[english]SteamAddOn_CheckingForUpdates"	"Checking for updates..."
"SteamAddOn_SystemMessage"	"%s1 - Systémová zpráva"
"[english]SteamAddOn_SystemMessage"	"%s1 - System Message"
}
}
