"lang"
{
"Language"	"greek"
"Tokens"
{
"SteamAddOn_GameTitle"	"%s1 - Παιχνίδι Steam"
"[english]SteamAddOn_GameTitle"	"%s1 - Steam Game"
"SteamAddOn_AppTitle"	"%s1 - Εφαρμογή Steam"
"[english]SteamAddOn_AppTitle"	"%s1 - Steam App"
"SteamAddOn_Yes"	"Ναι"
"[english]SteamAddOn_Yes"	"Yes"
"SteamAddOn_No"	"Όχι"
"[english]SteamAddOn_No"	"No"
"SteamAddOn_Black"	"Μαύρα"
"[english]SteamAddOn_Black"	"Black"
"SteamAddOn_White"	"Άσπρα"
"[english]SteamAddOn_White"	"White"
"SteamAddOn_Red"	"Κόκκινα"
"[english]SteamAddOn_Red"	"Red"
"SteamAddOn_Turn"	"Σειρά"
"[english]SteamAddOn_Turn"	"Turn"
"SteamAddOn_TurnLabel"	"Σειρά: %s1"
"[english]SteamAddOn_TurnLabel"	"Turn: %s1"
"SteamAddOn_WaitOpponentColor_Title"	"%s1 - Αναμένει την επιλογή χρώματος του αντιπάλου"
"[english]SteamAddOn_WaitOpponentColor_Title"	"%s1 - Waiting for Opponent Color Choice"
"SteamAddOn_WaitOpponentColor_Text"	"Δημιουργία %s1 παιχνιδιού. Αναμονή για τον χρήστη %s2 να επιλέξει χρώμα..."
"[english]SteamAddOn_WaitOpponentColor_Text"	"Setting up %s1 game. Waiting for %s2 to pick color..."
"SteamAddOn_PickColor_Title"	"%s1 - Επιλογή χρώματος"
"[english]SteamAddOn_PickColor_Title"	"%s1 - Decide Your Color"
"SteamAddOn_PickColor_Text"	"Δημιουργία %s1 παιχνιδιού. Τι χρώμα θα θέλατε να είστε;"
"[english]SteamAddOn_PickColor_Text"	"Setting Up %s1 game. What color would you like to be?"
"SteamAddOn_ColorWhite"	"Έχετε τα άσπρα."
"[english]SteamAddOn_ColorWhite"	"You are White. "
"SteamAddOn_ColorBlack"	"Έχετε τα μαύρα."
"[english]SteamAddOn_ColorBlack"	"You are Black. "
"SteamAddOn_ColorRed"	"Έχετε τα κόκκινα."
"[english]SteamAddOn_ColorRed"	"You are Red. "
"SteamAddOn_YourMove"	"Είναι η σειρά σας.\n"
"[english]SteamAddOn_YourMove"	"It is your Move.\n"
"SteamAddOn_OppMove"	"Είναι η κίνηση του αντιπάλου σας. \n"
"[english]SteamAddOn_OppMove"	"It is your opponent's move. \n"
"SteamAddOn_PlayerRejoin"	"Ο χρήστης %s1 έχει επανασυνδεθεί στο παιχνίδι. \n"
"[english]SteamAddOn_PlayerRejoin"	"%s1 has rejoined game.\n"
"SteamAddOn_RejoinDenied_Title"	"%s1 - Η επανασύνδεση απορρίφθηκε"
"[english]SteamAddOn_RejoinDenied_Title"	"%s1 - Re-join Denied"
"SteamAddOn_RejoinDenied_Text"	"Ο αντίπαλός σας απέρριψε την επανασύνδεση στο παιχνίδι."
"[english]SteamAddOn_RejoinDenied_Text"	"Your opponent has declined to rejoin the game."
"SteamAddOn_Turn_GameOver"	"Σειρά: %s1 %s2 νίκησε.\n"
"[english]SteamAddOn_Turn_GameOver"	"Turn: %s1 %s2 has won.\n"
"SteamAddOn_GameOver_Win"	"Νικήσατε τον χρήστη %s1 στο %s2."
"[english]SteamAddOn_GameOver_Win"	"You have beaten %s1 in %s2."
"SteamAddOn_GameOver_Loss"	"Ο χρήστης %s1 σας νίκησε στο %s2."
"[english]SteamAddOn_GameOver_Loss"	"%s1 has beaten you in %s2."
"SteamAddOn_GameOver_Tie"	"Το %s1 παιχνίδι έληξε ισοπαλία."
"[english]SteamAddOn_GameOver_Tie"	"%s1 game has ended in a tie."
"SteamAddOn_Resign_Title"	"%s1 - Ο αντίπαλος παραιτήθηκε από το παιχνίδι"
"[english]SteamAddOn_Resign_Title"	"%s1 - Opponent Resigned From Game"
"SteamAddOn_Resign_Text"	"Ο αντίπαλός σας παραιτήθηκε από το παιχνίδι."
"[english]SteamAddOn_Resign_Text"	"Your opponent has resigned from the game."
"SteamAddOn_GameOver_Title"	"%s1 - Τέλος παιχνιδιού"
"[english]SteamAddOn_GameOver_Title"	"%s1 - Game Over"
"SteamAddOn_WaitingForMoveHistory"	"Αναμονή για ιστορικό κινήσεων...\n"
"[english]SteamAddOn_WaitingForMoveHistory"	"Waiting for move history...\n"
"SteamAddOn_QuitGameConfirm_Title"	"Έξοδος παιχνιδιού"
"[english]SteamAddOn_QuitGameConfirm_Title"	"Quit Game"
"SteamAddOn_QuitGameConfirm_Text"	"Θέλετε σίγουρα να εξέλθετε από το παιχνίδι;"
"[english]SteamAddOn_QuitGameConfirm_Text"	"Are you sure you want to quit this game?"
"SteamAddOn_ConfirmResign_Title"	"Επιβεβαίωση παραίτησης"
"[english]SteamAddOn_ConfirmResign_Title"	"Confirm Resign"
"SteamAddOn_ConfirmResign_Text"	"Θέλετε σίγουρα να παραιτηθείτε;"
"[english]SteamAddOn_ConfirmResign_Text"	"Are you sure you want to resign?"
"SteamAddOn_ResignFromGame_Title"	"Παραίτηση από το παιχνίδι"
"[english]SteamAddOn_ResignFromGame_Title"	"Resign From Game"
"SteamAddOn_ResignFromGame_Text"	"Παραιτηθήκατε από το παιχνίδι."
"[english]SteamAddOn_ResignFromGame_Text"	"You have resigned from the game."
"SteamAddOn_Btn_CloseGameWindow"	"Κλείσιμο παραθύρου παιχνιδιού"
"[english]SteamAddOn_Btn_CloseGameWindow"	"Close Game Window"
"SteamAddOn_Btn_KeepGameWindow"	"Διατήρηση παραθύρου παιχνιδιού"
"[english]SteamAddOn_Btn_KeepGameWindow"	"Keep Game Window"
"SteamAddOn_Btn_Pass"	"&Πάσο"
"[english]SteamAddOn_Btn_Pass"	"&Pass"
"SteamAddOn_Btn_Resign"	"Πα&ραίτηση"
"[english]SteamAddOn_Btn_Resign"	"&Resign"
"SteamAddOn_Btn_ShowHistory"	"Προβολ&ή ιστορικού"
"[english]SteamAddOn_Btn_ShowHistory"	"Show &History"
"SteamAddOn_Btn_Send"	"Απο&στολή"
"[english]SteamAddOn_Btn_Send"	"&Send"
"SteamAddOn_Opp_Offline"	"Ο χρήστης %s1 αποσυνδέθηκε.\n"
"[english]SteamAddOn_Opp_Offline"	"%s1 has gone offline.\n"
"SteamAddOn_Opp_Online"	"Ο χρήστης %s1 συνδέθηκε ξανά."
"[english]SteamAddOn_Opp_Online"	"%s1 has come back online."
"SteamAddOn_Opp_ExitGame"	"Ο χρήστης %s1 εγκατάλειψε το παιχνίδι.\n"
"[english]SteamAddOn_Opp_ExitGame"	"%s1 has exited the game.\n"
"SteamAddOn_Waiting_Rejoin"	" Αναμονή για επανασύνδεση παίκτη.\n"
"[english]SteamAddOn_Waiting_Rejoin"	" Waiting for player to re-join game.\n"
"SteamAddOn_Close"	"ΚΛΕΙΣΙΜΟ"
"[english]SteamAddOn_Close"	"Close"
"SteamAddOn_ReviewMoves"	"Για επισκόπηση κινήσεων στο ταμπλό,\nκάντε κλικ από κάτω τους."
"[english]SteamAddOn_ReviewMoves"	"To review moves on the board,\nclick on them below."
"SteamAddOn_BuddyInvite"	"Προσκαλέστε τον χρήστη %s1"
"[english]SteamAddOn_BuddyInvite"	"Invite %s1"
"SteamAddOn_InvitationTitle"	"%s1 - Πρόσκληση"
"[english]SteamAddOn_InvitationTitle"	"%s1 - Invitation"
"SteamAddOn_InvitationText"	"Ο χρήστης %s1 σας προσκάλεσε στο %s2."
"[english]SteamAddOn_InvitationText"	"%s1 has invited you to %s2."
"SteamAddOn_InviteWaitTitle"	"%s1 - Αναμονή για απάντηση πρόσκλησης"
"[english]SteamAddOn_InviteWaitTitle"	"%s1 - Waiting on Invite Response"
"SteamAddOn_InviteWaitText"	"Αναμονή απάντησης πρόσκλησης για %s1 από τον χρήστη %s2"
"[english]SteamAddOn_InviteWaitText"	"Waiting on %s1 Invite Response from %s2"
"SteamAddOn_InviteRejectedTitle"	"%s1 - Πρόσκληση απορρίφθηκε"
"[english]SteamAddOn_InviteRejectedTitle"	"%s1 - Invite Rejected"
"SteamAddOn_InviteRejectedText"	"Ο χρήστης %s1 απέρριψε την πρόσκλησή σας."
"[english]SteamAddOn_InviteRejectedText"	"%s1 has rejected your invitation."
"SteamAddOn_OtherPlayerAbortTitle"	"Πρόωρη έξοδος"
"[english]SteamAddOn_OtherPlayerAbortTitle"	"Early Quit"
"SteamAddOn_OtherPlayerAbortText"	"Ο %s1 εγκατέλειψε πρόωρα το παιχνίδι."
"[english]SteamAddOn_OtherPlayerAbortText"	"%s1 has quit the game early."
"SteamAddOn_RejoinTitle"	"%s1 - Επανασύνδεση"
"[english]SteamAddOn_RejoinTitle"	"%s1 - Re-join"
"SteamAddOn_RejoinText"	"Έχετε συνδεθεί στο δίκτυο φίλων. \nΕπανένταξη σε %s1 με %s2;"
"[english]SteamAddOn_RejoinText"	"You have signed on to the Friends Network.\nRe-join %s1 with %s2?"
"SteamAddOn_Btn_Accept"	"&Αποδοχή"
"[english]SteamAddOn_Btn_Accept"	"&Accept"
"SteamAddOn_Btn_Reject"	"Από&ρριψη"
"[english]SteamAddOn_Btn_Reject"	"&Reject"
"SteamAddOn_Btn_Yes"	"Ναι"
"[english]SteamAddOn_Btn_Yes"	"&Yes"
"SteamAddOn_Btn_No"	"Ό&χι"
"[english]SteamAddOn_Btn_No"	"&No"
"SteamAddOn_WaitingAbortTitle"	"%s1 - Πρόωρη λήξη"
"[english]SteamAddOn_WaitingAbortTitle"	"%s1 - Ended Early"
"SteamAddOn_WaitingAbortText"	"Περιμένοντας δεδομένα, το %s1 έληξε."
"[english]SteamAddOn_WaitingAbortText"	"While waiting for data, %s1 has ended."
"SteamAddOn_LastMoveMade"	"Τελευταία κίνηση ελήφθη: %s1 στις %s2"
"[english]SteamAddOn_LastMoveMade"	"Last move received: %s1 at %s2"
"SteamAddOn_InvitingWaitingResponse"	"Προσκαλέσατε τον χρήστη %s1, αναμονή απάντησης...\n"
"[english]SteamAddOn_InvitingWaitingResponse"	"You have invited %s1, waiting on response...\n"
"SteamAddOn_AskingHostPermission"	"Ζητάτε από το διοργανωτή άδεια για πρόσκληση του %s1.\n"
"[english]SteamAddOn_AskingHostPermission"	"You are asking the host for permission to invite %s1.\n"
"SteamAddOn_InvitingToGame"	"Πρόσκληση του %s1 στο παιχνίδι.\n"
"[english]SteamAddOn_InvitingToGame"	"Inviting %s1 to game.\n"
"SteamAddOn_PlayerJoined"	"Ο χρήστης %s1 συνδέθηκε.\n"
"[english]SteamAddOn_PlayerJoined"	"%s1 has joined.\n"
"SteamAddOn_PlayerDeclinedInvite"	"Ο χρήστης %s1 απέρριψε την πρόσκληση.\n"
"[english]SteamAddOn_PlayerDeclinedInvite"	"%s1 has declined the invitation.\n"
"SteamAddOn_PlayerInvitePlayerWaitingResponse"	"Ο χρήστης %s1 προσκάλεσε τον χρήστη %s2, αναμονή απάντησης...\n"
"[english]SteamAddOn_PlayerInvitePlayerWaitingResponse"	"%s1 has invited %s2, waiting on response...\n"
"SteamAddOn_InviteQuitTitle"	"%s1 - Λήξη παιχνιδιού"
"[english]SteamAddOn_InviteQuitTitle"	"%s1 - Game Ended"
"SteamAddOn_InviteQuitText"	"Το παιχνίδι έληξε ενώ αναμενόταν η απάντησή σας."
"[english]SteamAddOn_InviteQuitText"	"The game has ended while waiting for your response."
"SteamAddOn_HostCancelInviteTitle"	"%s1 - Πρόσκληση Ακυρώθηκε"
"[english]SteamAddOn_HostCancelInviteTitle"	"%s1 - Invite Cancelled"
"SteamAddOn_HostCancelInviteText"	"Ο διοργανωτής ακύρωσε την πρόσκλησή σας."
"[english]SteamAddOn_HostCancelInviteText"	"The host has cancelled your invitation."
"SteamAddOn_WaitingStartInfo_Title"	"%s1 - Αναμονή για Πληροφορίες Παιχνιδιού"
"[english]SteamAddOn_WaitingStartInfo_Title"	"%s1 - Waiting for Game Information"
"SteamAddOn_WaitingStartInfo_Text"	"Αναμονή πληροφοριών εκκίνησης παιχνιδιού από το διοργανωτή..."
"[english]SteamAddOn_WaitingStartInfo_Text"	"Waiting for starting game information from host..."
"SteamAddOn_UserInvited"	"%s1 προσκλήθηκε..."
"[english]SteamAddOn_UserInvited"	"%s1 Invited..."
"SteamAddOn_HostQuitTitle"	"%s1 - Έξοδος εξυπηρετητή"
"[english]SteamAddOn_HostQuitTitle"	"%s1 - Host Quit"
"SteamAddOn_HostQuitText"	"Ο διοργανωτής έχει εγκαταλείψει %s1."
"[english]SteamAddOn_HostQuitText"	"Host has quit %s1."
"SteamAddOn_GameOver_TeamWin"	"Η ομάδα σας νίκησε την άλλη ομάδα στο %s1."
"[english]SteamAddOn_GameOver_TeamWin"	"Your team has beaten the other team in %s1."
"SteamAddOn_GameOver_TeamLoss"	"Η άλλη ομάδα νίκησε την ομάδα σας στο %s1."
"[english]SteamAddOn_GameOver_TeamLoss"	"The other team has beaten your team in %s1."
"SteamAddOn_Invite"	"Πρόσκληση"
"[english]SteamAddOn_Invite"	"Invite"
"SteamAddOn_Cancel"	"ΑΚΥΡΟ"
"[english]SteamAddOn_Cancel"	"Cancel"
"SteamAddOn_Points"	"Πόντοι:"
"[english]SteamAddOn_Points"	"Points:"
"SteamAddOn_Score"	"Βαθμολογία:"
"[english]SteamAddOn_Score"	"Score:"
"SteamAddOn_North"	"Βόρεια:"
"[english]SteamAddOn_North"	"North:"
"SteamAddOn_South"	"Νότια:"
"[english]SteamAddOn_South"	"South:"
"SteamAddOn_West"	"Δυτικά:"
"[english]SteamAddOn_West"	"West:"
"SteamAddOn_East"	"Ανατολικά:"
"[english]SteamAddOn_East"	"East:"
"SteamAddOn_LastTrick"	"Τελευταίο κόλπο"
"[english]SteamAddOn_LastTrick"	"Last Trick"
"SteamAddOn_CurrentTrick"	"Τρέχον κόλπο"
"[english]SteamAddOn_CurrentTrick"	"Current Trick"
"SteamAddOn_ShowScore"	"Προβολή Βαθμολογίας"
"[english]SteamAddOn_ShowScore"	"Show Score"
"SteamAddOn_HideScore"	"Απόκρυψη Βαθμολογίας"
"[english]SteamAddOn_HideScore"	"Hide Score"
"SteamAddOn_StartGame"	"Εκκίνηση παιχνιδιού"
"[english]SteamAddOn_StartGame"	"Start Game"
"SteamAddOn_UserLeftGameTitle"	"%s1 - Αποχώρηση χρήστη"
"[english]SteamAddOn_UserLeftGameTitle"	"%s1 - User Left Game"
"SteamAddOn_UserLeftGameText"	"Ο χρήστης %s1 αποχώρησε από το παιχνίδι.\n"
"[english]SteamAddOn_UserLeftGameText"	"%s1 has left the game.\n"
"SteamAddOn_MatchName"	"Όνομα παιχνιδιού: %s1"
"[english]SteamAddOn_MatchName"	"Match Name: %s1"
"SteamAddOn_WaitingForDeal"	"Αναμονή για μοίρασμα από το διοργανωτή.\n"
"[english]SteamAddOn_WaitingForDeal"	"We are waiting for host to deal out the hand.\n"
"SteamAddOn_DealNextHand"	"Μοίρασμα επόμενης παρτίδας"
"[english]SteamAddOn_DealNextHand"	"Deal Next Hand"
"SteamAddOn_RoundCompleted"	"Ο γύρος ολοκληρώθηκε."
"[english]SteamAddOn_RoundCompleted"	"Round Completed."
"SteamAddOn_DetailsAddendum"	"%s1\nΛεπτομέρειες: %s2"
"[english]SteamAddOn_DetailsAddendum"	"%s1\nDetails: %s2"
"SteamAddOn_SteamLoading"	"%s1 - Φόρτωση"
"[english]SteamAddOn_SteamLoading"	"%s1 - Loading"
"SteamAddOn_UpdatingAddOnsFiles"	"Ενημέρωση %s1 αρχείων..."
"[english]SteamAddOn_UpdatingAddOnsFiles"	"Updating %s1 files..."
"SteamAddOn_OtherPlayerUpdating"	"Ο άλλος παίκτης πρέπει να ενημερώσει το παιχνίδι..."
"[english]SteamAddOn_OtherPlayerUpdating"	"Other player needs to update game..."
"SteamAddOn_PlayerLoggedOff"	"Ο %s1 έχει αποσυνδεθεί.\n"
"[english]SteamAddOn_PlayerLoggedOff"	"%s1 has logged off.\n"
"SteamAddOn_HostCancelledDuringAccept"	"Ο διοργανωτής ακύρωσε τις προσκλήσεις μας ενώ δεχόμασταν.\n"
"[english]SteamAddOn_HostCancelledDuringAccept"	"Host cancelled our invitation as we were accepting.\n"
"SteamAddOn_CancellingInvitation"	"Ακύρωση πρόσκλησης του %s1.\n"
"[english]SteamAddOn_CancellingInvitation"	"Cancelling invitation to %s1.\n"
"SteamAddOn_HostCancelOtherPlayer"	"Ο διοργανωτής (%s1) ακύρωσε την πρόσκληση του %s2.\n"
"[english]SteamAddOn_HostCancelOtherPlayer"	"Host (%s1) cancel invitation to %s2.\n"
"SteamAddOn_PlayerAcceptedInvite"	"Ο %s1 έχει δεχτεί την πρόσκληση και τώρα ελέγχει για ενημερώσεις...\n"
"[english]SteamAddOn_PlayerAcceptedInvite"	"%s1 has accepted the invitation and is now checking for updates...\n"
"SteamAddOn_WaitingQuit"	"%s1 - Έξοδος"
"[english]SteamAddOn_WaitingQuit"	"%s1 - Quit"
"SteamAddOn_HostInviteOffline"	"Ο χρήστης %s1 είναι εκτός σύνδεσης, τερματισμός αιτήματος πρόσκλησης στον χρήστη %s2"
"[english]SteamAddOn_HostInviteOffline"	"%s1 has gone offline, ending invite request to %s2"
"SteamAddOn_HostRejoinOffline"	"Ο χρήστης %s1 είναι εκτός σύνδεσης, λήξη αιτήματος επανένταξης σε %s2"
"[english]SteamAddOn_HostRejoinOffline"	"%s1 has gone offline, ending rejoin request to %s2"
"SteamAddOn_HostInviteQuit"	"Ο χρήστης %s1 έχει εγκαταλείψει, τερματισμός πρόσκλησης σε %s2"
"[english]SteamAddOn_HostInviteQuit"	"%s1 has quit, ending invite to %s2"
"SteamAddOn_CheckingForUpdates"	"Γίνεται έλεγχος για ενημερώσεις..."
"[english]SteamAddOn_CheckingForUpdates"	"Checking for updates..."
"SteamAddOn_SystemMessage"	"%s1 - Μήνυμα συστήματος"
"[english]SteamAddOn_SystemMessage"	"%s1 - System Message"
}
}
